27 19 44 40 18 21 29 38
19 32 08 52 33 55 03 24
48 39 25 03 18 07 14 02
22 05 07 36 31 55 27 50
06 03 17 21 22 34 41 49
33 04 13 30 11 39 22 29
53 02 22 19 23 26 43 47
40 42 22 28 24 16 14 20
10 19 31 46 20 48 49 30
18 10 35 56 32 22 15 51
09 44 48 57 22 12 08 45
28 56 50 04 57 17 19 25
07 16 08 11 56 38 53 49
40 55 39 57 53 41 46 15
08 04 18 20 23 36 41 37
30 32 41 26 25 27 12 16
34 51 50 40 54 02 30 08
14 13 08 17 35 27 47 46
55 43 13 49 54 12 28 18
03 31 09 13 26 37 56 40
50 21 48 13 52 23 16 15
27 15 09 04 01 49 02 25
24 57 37 30 07 21 43 35
13 34 25 53 24 36 10 44
43 42 29 31 08 15 25 06
06 19 36 35 16 39 54 09
06 53 48 51 33 37 27 28
06 44 01 55 56 30 23 14
06 24 11 26 18 45 46 50
45 47 36 38 28 30 15 03
12 02 21 46 42 56 33 36
33 44 54 17 20 26 15 07
10 38 41 50 43 33 14 09
09 47 25 11 21 20 55 51
47 37 32 50 42 39 44 49
35 02 28 41 31 44 52 11
20 52 39 43 45 34 56 27
04 14 21 32 31 53 54 45
19 11 15 14 12 05 37 34
01 10 21 08 05 26 28 39
20 05 32 02 38 06 13 57
04 06 10 12 07 40 52 47
38 12 24 23 17 31 39 51
37 10 16 17 02 29 45 55
56 47 48 41 54 29 24 05
05 18 09 17 30 53 42 52
05 35 49 40 33 45 25 23
04 05 03 16 51 46 43 44
01 37 52 46 54 38 22 25
01 57 16 47 34 33 31 18
10 03 11 57 23 27 42 54
20 35 01 03 53 50 12 29
04 55 48 35 38 42 34 26
14 57 36 26 52 49 51 29
40 17 48 01 43 36 32 11